100
OOOOOOOOOOOOOOOOOOOOOOOOOOOOOOOOOOOOOOOOOOOOOOOOOOOOOOOOOOOOOOOOOOOOOOOOOOOOOOOOOOOOOOOOOOOOOOOOOOOOOOOOOOOOOOOOOOOOOOOOOOOOOOOOOOOOOOOOOOOOOOOOOOOOOOOOOOOOOOOOOOOOOOOOOOOOOOOOOOOOOOOOOOOOOOOOOOOOOOOOOOOOOOOOOOOOOOOOOOOOOOOOOOOOOOOOOOOOOOOOOOOOOOOOOO
OOOOOOOOO....OOOOOOOOO......OOOOOOOOOOOOOOOOOOOOOOOOOOOOOOOOOOOOOOOOOOOOOOOOOOOOOOOOOOOOOOOOOOOOOOOOOOOOOOOOOOOOOOO....OOOOO....O.....OO........OO..............................................OOOOOOOOOOOOOOOO....OOOOOOOOOOOO....OOOOOOOOOOO.OOO.OOOOOO
O.......OOOOOO.......OOOOOOOO.........OOOOOOO.........OOOOOOO......OOOOOOO.........OOOOOO.........OOOOOOO.........OOOOOOO.......O.....OO........OO..............................................OOOOOO.........OOOOOOO.........OOOOOOO........OOOOOOO....O
O.......O....O.......O......OO....................................................................OO....OOOOOOOOOOO....OOOOO....O.....OO........OO............................................OOO....OOO..OOOOOO....OOOOO...OOOO....OOO.OOOOOOO.OO.......O
O..OOOOOO....OOOOOO..O.......OO...................................................................O.......................OO....O.....OO........OO....................................OOOOO..OO........O..O.............OOOOO........OOOO........O.......O
O.OO..............OO.O........O.OOOOOOOOOOOOOOOOOOOOOOOOOOOOOOOOOOOOOOOOOOOOOOOOOOOOOOOOOOOOOOOOOOO.......................OO....O.....OO........OOOOOOOOOOOOOO........................O...O..O.........O..O.............OO.............OO........O.......O
O.O...............OO.O........O.OOOOOOOOOOOOOOOOOOOOOOOOOOOOOOOOOOOOOOOOOOOOOOOOOOOOOOOOOOOOOOOOOO........................OO....O.....OO........OOO..........O........................O...O..O.........O..O.............OO.............OO........O.......O
O.O...............OO.O........O.O..............OO..............OO..............OO.............OOOO........................OO....O.....OO........OOO..........O....OOOOOOOOOOOOOOOOOOOOO...O..O.........OOOO.............OO.............OO........O.......O
O.O...............OO.OOO....OOO.O..............OO..............OO..............OO.............OOOO........................OO....O.....OO........OOO..........O....O.......................O..O...........OO.............OO.............OO........O.......O
O.O...............OO...O....OOOOO..............OO..............OO..............OO.............OOOO........................OO....O.....OO........OOO..........O....O.......................O..O...........OO.............OO.............OO........O.......O
O.O...............OO...O....OOOOO..............OO..............OO..............OO.............OOOO........................OO....O.....OO........OOO..........O....O.......................O..O...........OO.............OO.............OO........O.......O
O.O...............OO...O.......OO..............OO..............OO..............OO.............OOOO........................OO....O.....OO........OOO..........O....O...................OOOOO..O...........OO.............OO.............OO........O.......O
O.O...............OO...O.......OO..............OO..............OO..............OO.............OOOO........................OO....O.....OO........OOO..........O....O...................O......O...........OO.............OO.............OO........OOOOOOOOO
OOO...............OO.OOO.......OO..............OO..............OO..............OO.............OOOO..............OOOOOOOOOOOO....O.....OO........OOO..........O....O...................O......O...........OO.............OO.............OO........OOOOOOOOO
OO................OO.O.........OO..............OO..............OO..............OO.............OOOO..............OOOOOOOOOOOO....O.....OO........OOO..........O....O...................OO.....O...........OO.............OO.............OO................O
OO................OO.O.........OO..............OO..............OO..............OO.............OOOO........................OO....O...............OOO..........O....O....................O.....O...........OO.............OO.............OO................O
OO................OO.O.........OO..............OO..............OO..............OO.............OOOO........................OO....O...............OOO..........O....O....................O.....O...........OO.............OO.............OO........O.......O
OO................OO.O.........OO..............OO..............OO..............OO.............OOOO........................OO....O...............OOO..........O....O....................O.....O...........OO.............OO.............OO........OOOOOOOOO
OOO...............OO.O.........OO..............OO..............OO..............OO.............OOOO........................OO....O.....OO........OOO..........O....O....................O.....O.........OOOO.............OO.............OO........O.......O
OOO...............OO.O.........OO..............OO..............OO..............OO.............OOOO..............OOOOOOOOOOOO....O.....OO........OOO..........O....O....................O.....O.........O..O...........OOOO.............OO................O
O.O...............OO.O.........OO..............OO..............OOOO............OO.............OOOO..............OOOOOOOOOOOO....O.....OO........OOO..........O....O....................O.....O.........O..O...........OOOO.............OO................O
O.O...............OOOO......OOOOO..............OO..............O..O............OO.............OOOO........................OO....O.....OO........OOO..........O....O....................O.....O.........O..O...........O..O.............OO........O.......O
OOO...............OOOO......OO..O..............OO..............O..O............OO.............OO.O........................OO....O....OOOOOOOOOOOOOO..........O....OOOOOO...............O.....O.........O..O...........O..O.............OO........OOOOOOOOO
OO................OOO.......OO..O..............OO..............O..O............OO.............OO.O........................OO....O....O............O........OOO........OO...............OO....OO........O..O...........O..OOOO..........OO........OOOOOOOOO
OO................OOO.......OO..O..............OO..............O..O............OO.............OO.O........................OO....O....O......OOOOOOO........O..........OO................O.....O........O..O...........O.....O..........OO........OO.....OO
OO................OOO.......OO..O..............OO..............O..O............OO.............OO.O........................OO....O....O......OO.............O..........OO................O.....O........O..O...........O.....O..........OO........OO.....OO
OO................OOOOOO....OOOOOOO............OO...........OOOOOOOO...........OOO...........OOOOOOOO........OOOOOOOOOOOOOOOOOOOO....OOOOOOOOO.............OOOOOOOOOOOOO........OOOOOOOOOOOOOOOOO....OOOOOOO.....OOOOOOOOOOOOOOOOO....OOOOOOO...OOOO...OOO
OOO...............OOOOOO....OOOOOOO............OO...........OOOOOOOO...........OOO...........OOOOOOOO........OOOOOOOOOOOOOOOOOOOO....OOOOOOOOO.............OOOOOOOOOOOOO........OOOOOOOOOOOOOOOOO....OOOOOOO.....OOOOOOOOOOOOOOOOO....OOOOOOO...OOOO...OOO
OOO...........................................................................................OO.........................................................................................................................................................O
O.O......................................................................................................................................................................................................................................................O
OOO......................................................................................................................................................................................................................................................O
OOO......................................................................................................................................................................................................................................................O
OO.......................................................................................................................................................................................................................................................O
OO.......................................................................................................................................................................................................................................................O
OO.......................................................................................................................................................................................................................................................O
OO................OOO....................................................................................................................................................................................................................................O
OOO...............OOO....................................................................................................................................................................................................................................O
O.OOOOOOOOOOOOOOOOOOO.........................................................................OO.........................................................................................................................................................O
O.....OOOOOOOOOOOOOOO..........OOOOOOOOOOOOOOOOOO..........OOOOOOOOOOOOOOOOOOOO..........OOOOOOOOOOOOOOOOOOO...OOOOOOOOOOOOOOOOOOOOOOOOOOOOOOOO............OOOOOOOOOOOOOOOOOOOOOOOOOOOOOOOOOOOOOOO....OOOOOOOOOOOO....OOOOOOOOOOO....OOOOOOOOOOOO....OOOOO
O.....OOOOOOOOOOOOOOO..........O..OOOOOOOOOOOOOOO..........O.................OO..........OOOOOOOOOOOOOOOOOOO...OOOOOOOOOOOOOO....OOOOOOOOOOOOOO............O..................................OOOO....OOOOOOOOOOOO....OOO...OOOOO....OOOOOOOOOOOO....OOOOO
O.....OO........OO.............O..O........................O.................OO..........OO..............OO................OO....OO..........OO............O..................................O............OO...........O...OO............OO............OO
OOOOOOOO........OO.............OOOO........................O.................OO..........OO..............OO................OOO...OO..........OO............OOOOOOOOOOOOOOOOOOOOOOOOOOOOOO...OOO............OO...........OO.OOO............OO............OO
OOOOOOOO........OOOOO..........OO..........................O..OOOOOOOOOOOOO..OO..........OO..............OO.................OO...OO..........OOOO........OOOO...........................O...OO.............OO............O.OO.............OO.............O
OO..............OO..O..........OO..........................O..OOOOOOOOOOOOO..OO..........................OO.................OO...OO..........OOOO........OOOO...........................O...OO.............OO............O.OO.............OO.............O
OO..............OO..O..........OO..........................O..O...........O..OO..........................OO.................OOOOOOO..........OO............OO...........................O...OO.............OO............O.OO.............OO.............O
OO..............OO..O..........OO..........................O..O...........O..OO..........................OO.................OO...............OO............OO...........................OOOOOO.............OO............O.OO.............OO.............O
OO..............OO..O..........OO..........................OO.O...........O.OOO..........................OO.................OO...............OO.........................................OOOOOO...........................O.OO.............OO.............O
OO..............OO..O..........OO...........................OOO...........OOOO...........OO..............OO.................OO..............................................................OO...........................O.OO.............OO.............O
OO..............OOOOO..........OO........................................................OO..............OO.................OO..............................................................OO...........................O.OO.............OO.............O
OO.............................OO........................................................OO..............OO.................OO..............................................................OO...........................O.OO.............OO.............O
OO.............................OO........................................................OO..............OO.................OO..............................................................OO...........................O.OO.............OO.............O
OOOO...........................OO..............OO........................................OO..............OO.................OO..............................................................OO...........................O.OO.............OO.............O
O..O...........................OO..............OO........................................OO..............OO.................OO..............................................................OO...........................O.OO.............OO.............O
O..OOOOOOOOOOOOOOOOOOOO.....OOOOO..............OO........................................OO..............OO.................OO..............................................................OO...........................O.OO.............OO.............O
OOOOOOOOOOOOOOOOOOOOOOO.....OOOOO..............OO........................................OO..............OO.................OO..............................................................OO...........................O.OO.............OO.............O
OO.............................OO..............OO........................................OO..............OO.................OO..............................................................OO...........................O.OO.............OO.............O
OO.............................OO..............O.........................................OO..............OO.................OO..............................................................OO...........................O.OO.............OO.............O
OO.............................OO..............O.........................................OO..............OO.................OO..............................................................OO........................OOOO.OO.............OO.............O
OO.............................OO..............O.........................................OO..............OO.................OO..............................................................OO........................O....OOO............OO.............O
OOOO...........................OOO.............O..............OOOOOOOOOOO................OOOO............OO.................OO...............OO............OOOOOOOOO........................OO........................O......O...........OOOO............O
O.OO...........................OOO.............O..............OO.......OO................OOOO............OO...............OOOOOOOOOOOOOOOOOOOOO............OOOOOOOOO........................OOO..........OOO..........O......O...........O.OO...........OO
OOOO........................OOOO.O.............OO.............OO.......OO..................OO............OO...............OO...OO...........OOO............O..O...OO......................OOO.O..........O.O..........O......O...........O.OO...........OO
OOOO........................OOOO.O.............OO.............OO.......OO..................OO............OO...............OO...O...........................O..O...OOOOOOOOOOOOOOOOOOOOOOOOO...OOOOOOOOOOOO.OO.....OOOOO......OOOOOOOO....O.OOO....OOOOOOOO
OO..........................O....OOOOOOOOOOOOOOOOO.....OOOOOOOOO.......OOOO.....OOO.....OOOOOOOOOOOOOOOOOOO.............OOOO.OOO...........................OOOO...OOO.....OOOO...........OO.OOOOOOOOOOOOOOOOO.....OOOOOOOOOOOOOOOOOOO....OOOOO....OOOOOOOO
OO..........................O..OOOOOOOOOOOOOOOOOOO.....OOOOOOOOOOOOOOOOOOOO.....OOO.....OOOOOOOOOOOOOOOOOOO.............OO...O.............................OOOO...........................OOOO...........................................................O
OO..........................OOOOO.......................OO......................OO.......................OO.............OO...O..............................................................OO...........................................................O
OO..........................OOOOO.......................OO......................OO.......................OO.............OO...O..............................................................OO...........................................................O
OO.............................OO.......................OO.......................O.......................OO.............OO...O..............................................................OO...........................................................O
OO.............................OO.......................OO.......................O.......................OO.............OO...O..............................................................OO...........................................................O
OO.............................OO.......................OO.......................O.......................OO.............OOOO.O..............................................................OO...........................................................O
OO.............................OO.......................OO.......................O.......................OO................O.O..............................................................OO...........................................................O
OO.............................OO.......................OO.......................O.......................OO................O.O..............................................................OO...........................................................O
OO.............................OO.......................OO.......................O.......................OO................O.O..............................................................OO...........................................................O
OO.............................OO.......................OO.......................O.......................OO................O.O..............................................................OO...........................................................O
OO.............................OO.......................OO.......................O.......................OO................O.O..............................................................OO...........................................................O
OO.............................OO.......................OO.......................O.......................OO................O.O...............OO.............................................OO...........................................................O
OOOOOOO........................OO.......................OO.......................O.......................OO................O.OOOOOOOOO.......OO........OOOOOOOOOOOOO........................OO...........................................................O
O.....O......................OOOO.......................OO.......................O.......................OO................O.OOOOOOOOO.......OO........O...........O.......OO........OOOOOOOOO...........................................................O
O.....O......................O.OO.......................OO....OOOO..............OO.......................OOO...............O.........O.......OO........O...........O.......OO........OO.....OO............................OOO...........................OO
O.....OOOO....OOOOOOOO....OOOO.OOOOO.........OOOOOOOO...OO...OOOOOO........OOOOOOOO........OOOOOOOO......OOO...............O.........O.......OO........O...........OOOOOOOOOO........OO.....OOOOO........OOOOOO.........OOOOOOO........OOOOOOO........OOOO
O........OOOOOO......OOOOOOO.......OOOOOOOOOOO......OOOOOOOOOOO..OOOOOOOOOOO......OOOOOOOOOO......OOOOOOOOOOOOOOOOOOOOOOOOOO...OOOOOOO.......OO........O....................O........OO.........OOOOOOOOOO....OOOOOOOOOOO.....OOOOOOOOOO....OOOOOOOOOOO..O
O........OOOOOO......OOOOOOO.......OOOOOOOOOOO......OOOOOOOOOOO..OOOOOOOOOOO......OOOOOOOOOO......OOOOOOOOOO....OOOOOOOOOO.....O.............OO........O....................O........OO......OOOO........OOOOOO.........OOOOOOO........OOOOOOO........OOOO
OOOOOOOOOO....OOOOOOOO....OOOOOOOOOO.........OOOOOOOO........OOOOOO........OOOOOOOO........OOOOOOOO........OOOOOO........OOO..OO.............OOO...OOOOO....................O........OOOOOOO.O..........................................................OO
O..........................................................................................................................O..O..............OOO...OOOOOOOOOOOOOOOOOOOOOOOOOO..............O.O...........................................................O
O..........................................................................................................................O..O..............OO............................OO..............O.O...........................................................O
O..........................................................................................................................O..O..............OO............................OO..............OOO...........................................................O
O..........................................................................................................................O..O..............OO............................OO...............O............................................................O
O..........................................................................................................................O..O..............OO............................OO...............O............................................................O
O..........................................................................................................................O..O..............OO............................OO...............O............................................................O
O..........................................................................................................................O..O..............OO............................OO...............O............................................................O
O..........................................................................................................................O..O..............OO............................OO..............OOO...........................................................O
O..........................................................................................................................O..O..............OO............................OO..............O.O...........................................................O
O..........................................................................................................................O..O..............OO............................OO..............O.O...........................................................O
O..........................................................................................................................O..O..............OO............................OO..............O.O...........................................................O
O..........................................................................................................................O..O..............OO............................OO..............O.O...........................................................O
O..........................................................................................................................O..O..............OO............................OO..............O.O...........................................................O
O..........................................................................................................................O..OOOO...........OO............................OO..............O.O...........................................................O
O..........................................................................................................................O..OOOO...........OO............OOOOO...........OO.............OO.O...........................................................O
O..........................................................................................................................O.....OOO....OOOOOOOOO........OOO..OOO........OOOOOOOO....OOOOOOO.O...........................................................O
OOOOOOOOOOOOOOOOOOOOOOOOOOOOOOOOOOOOOOOOOOOOOOOOOOOOOOOOOOOOOOOOOOOOOOOOOOOOOOOOOOOOOOOOOOOOOOOOOOOOOOOOOOOOOOOOOOOOOOOOOOOOOOOOOOOOOOOOOOOOOOOOOOOOOOOOOOOOOOOOOOOOOOOOOOOOOOOOOOOOOOOOOOOOOOOOOOOOOOOOOOOOOOOOOOOOOOOOOOOOOOOOOOOOOOOOOOOOOOOOOOOOOOOOOO
